                              |                              
                              |                              
 /---- |     | /----\  -----  |  \       | /---- |   / ----- 
 |     |     | |    |    |    |  |\      | |     |  /    |   
 |     |     | |    |    |    |  | \     | |     | /     |   
 |     |     | |----/    |    |  |  \    | |     |/      |   
 |     |     | |    \    |    |  |   \   | \---\ |\      |   
 |     |     | |    |    |    |  |    \  |     | | \     |   
 |     |     | |    |    |    |  |     \ |     | |  \    |   
 \---- \-----/ \----/  -----  |  |      \| ----/ |   \ ----- 
                              |                              
         ----- /----          |       ----- |    | /----     
           |   |              |         |   |    | |         
           |   |              |         |   |    | |         
           |   \---\          |         |   |----| |----     
           |       |          |         |   |    | |         
           |       |          |         |   |    | |         
         ----- ----/          |         |   |    | \----     
                              |                              
                 /----\ /---- | /---- -----                  
                 |    | |     | |       |                    
                 |    | |     | |       |                    
                 |-- -/ |---- | \---\   |                    
                 |    \ |     |     |   |                    
                 |    | |     |     |   |                    
                 |    | |     |     |   |                    
                 \-- -/ \---- | ----/   |                    
                              |                              
                              |                              
                              |                              
